1111111111111111111111111111111111111111
1000000000000000000110000000000000000001                   
1000000000000000000110000000000000000001                                     
1000000000000000000110000000000000000001                                     
1000111100011111000110001111100011110001
1000111100011111000110001111100011110001
1000111100011111000110001111100011110001
1000000000000000000000000000000000000001
1000000000000000000000000000000000000001
1000000000000000000000000000000000000001
1000111100010001111111111000100011110001
1000111100010001111111111000100011110001
1000000000010000000110000000100000000001
1000000000010000000110000000100000000001
1000000000010000000110000000100000000001
1111111100011111000110001111100011111111
1111111100011111000110001111100011111111
1111111100010000000000000000100011111111
1111111100010000000000000000100011111111
1111111100010000000000000000100011111111
1111111100010001110000111000100011111111
0000000000000001000000001000000000000000
0000000000000001000000001000000000000000
0000000000000001000000001000000000000000
1111111100010001000000001000100011111111                   
1111111100010001111111111000100011111111
1111111100010000000000000000100011111111
1111111100010000000000000000100011111111
1111111100010000000000000000100011111111
1111111100010001111111111000100011111111
1111111100010001111111111000100011111111
1000000000000000000110000000000000000001
1000000000000000000110000000000000000001
1000000000000000000110000000000000000001                                  
1000111100011111000110001111100011110001
1000111100011111000110001111100011110001
1000001100000000000000000000000011000001                                
1000001100000000000000000000000011000001
1000001100000000000000000000000011000001 
1110001100010001111111111000100011000111
1000000000010000000110000000100000000001
1000000000010000000110000000100000000001
1000000000010000000110000000100000000001
1000111111111111000110001111111111110001
1000111111111111000110001111111111110001
1000000000000000000000000000000000000001
1000000000000000000000000000000000000001
1000000000000000000000000000000000000001
1111111111111111111111111111111111111111